ACAD9	AR
ACTA1	AR,AD
ACTA1	AR,AD
ADCY5	AD
ALMS1	AR
BBS2	AR
BOLA3	AR
CHKB	AR
CPT2	AR
CPT2	AR
CRYAB	AD
DES	AD,AR
DMD	XLR
DNAJC19	AR
DOLK	AR
DSP	AD
DSP	AR
EPG5	AR
ERBB3	AR
FHL1	XL
FKRP	AR
FKTN	AR
GATA5	AR,AD
GLB1	AR
HADHA	AR
HADHB	AR
HADHSC	AR
HJV	AR
JUP	AR
KAT6B	AD
LAMP2	XLD
LIMS2	AR
LMNA	AD
LMNA	AD
LMNA	AD
LMNA	AD
MGME1	AR
MYH7	AD
MYH7	AR
NDUFB11	XLD
PGM1	AR
POLG	AR
RBCK1	AR
RYR2	AD
SDHA	AR
SDHAF1	AR
SDHD	AR
SELENON	AR,AD
SGCB	AR
SPEG	AR
TAZ	XLR
TERT	AR,AD
TERT	AR,AD
TFAM	AR
TGFB3	AD
TNNI3K	AD
TPM3	AR,AD
TSFM	AR
TTN	AR
UBR1	AR
XK	XL
XPNPEP3	AR
XRCC4	AR
